#################
#*          #   #
# # ### ### # # #
#   #   #       #
### # # # # # # #
#         #     #
# ### ### # # ###
#         #     #
# # ### # # # # #
# #         #   #
# # # # ### # # #
# #       #     #
# # # # # # ### #
#     #       # #
# # # ### ### ###
#   #          o#
#################