#################
#           #   #
# # ### ### # # #
#   #   #       #
### # # # # # # #
#         #     #
# ### ### # # ###
#         #     #
# # ### # # # # #
# #         #   #
# # # # ### # # #
# #       #    ##
# # # # # # ### #
#     #       #*#
# # # ### ### ###
#   #          o#
#################