############
# #        #
# # ###### #
# # #  #   #
# ### *# # #
#   #### # #
# # #  # # #
# # # ## # #
#o#      # #
############